1111111111111111111111111
100000P00CCCE000000000001
1111111111111111111111111