11111111111111111
1000P0ECCCCCCCCC1
11111111111111111