1111111111111111111111111
1000000000000000000000001
100PCCC000000000000C00001
10000000E0000000000000001
1000CCC000000000000000001
1000000000000000000000001
1111111111111111111111111