1111111111111111111111111111111111111111
1P000000000C00000000C0000000000000000001
1011110111101111101110111110111011110111
1C000000C000000C000000C000000C00000000C1
1011101110111110111011111011101110111011
1C000000C000000000C000C000000000C00000C1
1110111011101111111011101110111111101111
1C000C000C000C000000000C000C0000000000C1
1011111011101111101110111011101110111011
1C000000C000000000C000000000000C000C0001
1110111011111011101110111110111110111011
1C000000000000C000000C000000C00000000C01
1011111011101110111110111110111011111011
1C000000C000000C000000000000000000C000E1
1111111111111111111111111111111111111111