1111111111111111111111111
10000P00000C0000000000001
100ECCCCCCCCCCCCCCCCCC001
1010101010101000101010101
1000000000000000000000001
1101010101010101010101011
1000011111000011111100001
1000000000000000000000001
11C1C1C1C1C1C1C1C1C1C1C11
11C1C1C1C1C1C1C1C1C1C1C11
11C1C1C1C1C1C1C1C1C1C1C11
1111111111111111111111111
