1111111111111111111111
1000000001111100000001
10000P11111000CCCCCCC1
111CCC1111111111110001
10111C11111111111000C1
10C00C00C00000CCCCCCC1
1111000000000000000001
1ECCCCCCCCCCCCCCCCCCC1
1CCCCCCCCCCCCCCCCCCC11
1111111111111111111111