1111111111111111111111
1P0000000000C0000000E1
1011111111101111111101
1010000C000010000C0101
1010111011101011101011
1010101010101010101011
1010101010101010101011
1C10000000000000000111
1110111111101111111011
1000100000100000001011
1011101110101111101011
1010001000101000101011
1010111011101010111011
1010100010001010100011
1010101111111010101111
1010100000000010100001
1010111111101110111101
1000000C0000000000C001
1111111111111111111111